12 12
###########
# ... ..... 
#.. . .   . 
#   ....... 
# ....   ..
#    . . .. 
# .. . . .. 
#  . . . .. 
# ......... 
#  P   .  . 
# ...... .. 
###########
